
NO background.xpm
SO background.xpm
WE background.xpm
EA background.xpm
F 150,240,140
C 255,255,255


     111111111111111111111
11111100000110000000000001
1011000001110000000000001
10000000000000E000000000111111111
111111111011000001110000000000001
100000000011000001110111110111111
11110111111111011100000010001
11110111111111011101010010001
11000000110101011100000000001
10000000000000000000000010001
10000000000000001101010010001
1100000111010101111101110000111
11110111 1110101 101111010001
   111    111111  11  11111111
