
NO textures/wood.xpm
SO textures/cobblestone.xpm
WE textures/grass_block.xpm
EA textures/bricks.xpm
F 150,240,140
C 255,255,255


  1  111111111111111111111
11011100000110000000000001
1011000001110000000000001
10000000000000E000000000111111111
111111111011000001110000000000001
100000000011000001110111110111111
11110111111111011100000010001
11110111111111011101010010001
11000000110101011100000000001
10000000000000000100000010001
110000000000000001101010010001
1100000111010101111101110000111
11110111 1110101 101111010001
   11    111111  11  11111111
