
NO textures/wood.xpm
SO textures/cobblestone.xpm
WE textures/grass_block.xpm
EA textures/bricks.xpm
DO textures/door.xpm
F 62,51,46
C 117,165,242


  1  111111111111111111111
11011100000110000200000001
1021000001110000020000001
100000000000000002000000111111111
111111111011000001110000000000001
100000000011000001110111112111111
111121111111110111000N0010001
11112111111111011101010010001
11000000110101211100000000001
10000000000000000200000010001
110000000000000001101010010001
1100000111010101111101110000111
11110111 1110101 101111010001
   11    111111  11  11111111
