NO textures/wood.xpm
SO textures/cobblestone.xpm
WE textures/grass_block.xpm
EA textures/bricks.xpm
DO textures/door.xpm
F 62,99,12
C 117,167,242

  1  111111111111111111111
11011100000110000200000001
1121000001110000020000001
100000000000000002000000111111111
111111111011000001110000000000001
100000000011000001110111112111111
11112111111111011100000010001
11112111111111011101010010001
11000000110101211100000000001
100000000000000002000000100011
11000000E0000000011101010010001
1100000111010101111101110000111
11110111 1110101 101111010001
   11    111111  11  11111111 1
